39
                          xxxxxxxxx    
                         x o      x    
                        x   x   x  x   
             xx         x           x  
            x  x         x     o   x   
            x o x         x       x    
             x  x        xx  x   x x   
        xxxxx    xx    xx  xx ---   x  
     xxx           x  x              x 
    x               x x              x 
   x      ---         x               x
   x     xhohx       x        x---x   x
  x       x x       |         x   x   x
  x        x        |         x s x   x
 x    o             x    o     xxx   x 
x                  x                 x 
x     xx           x                x  
x    xh |         |                  x 
 x   xh |         |                  x 
  x   xx         x         o        x  
   xx      o    x                    x 
     xxx        x                    x 
        xxxxxxxxx xx   x            x  
               x x  --- xx  x        x 
              x           xx xx     x  
          xxxxxxx   x o        x   x   
         x       -- xx x     o  --- x  
      xxx             x xxx---    xx   
     x       o       x        xx  x    
    x               |          x x     
    x               |             x    
    x              x       o       x   
   x   o        xxxx               x   
  x         xxxx    xxxxxxx    o    x  
   x       x               x         x 
    xx    x                 x      xx  
      xxxx                    xxxxx    